30
1 20 -1 0 161 543 3 -1 -1
2 20 -1 575 161 33 5 -1 -1
3 20 -1 640 161 32 4 -1 -1
4 20 -1 704 161 32 5 -1 -1
5 20 -1 768 159 32 6 -1 -1
6 20 -1 799 127 33 6 -1 -1
7 20 -1 832 96 129 5 -1 -1
8 20 -1 1023 159 65 5 -1 -1
9 20 -1 1119 160 288 4 -1 -1
10 20 -1 1215 95 33 6 -1 -1
11 20 -1 1279 95 97 5 -1 -1
12 20 -1 1317 204 51 3 -1 -1
13 20 -1 1407 128 32 4 -1 -1
14 20 -1 1439 95 32 6 -1 -1
15 20 -1 1472 64 63 3 -1 -1
16 20 -1 1599 161 16 3 -1 -1
17 20 -1 1662 161 18 3 -1 -1
18 20 -1 1726 159 18 6 -1 -1
19 20 -1 1791 160 256 4 -1 -1
20 126 -1 438 130 23 31 -1 -1
21 122 -1 388 132 24 31 -1 -1
22 122 -1 488 133 21 30 -1 -1
23 122 -1 339 134 24 27 -1 -1
24 121 -1 548 65 24 27 -1 -1
25 121 -1 679 69 23 23 -1 -1
26 124 -1 872 65 23 33 -1 -1
27 122 -1 1145 133 21 29 -1 -1
28 120 -1 1191 134 22 28  -1 -1
29 80 82 250 100 23 31 -1 -1
30 81 83 150 100 23 31 -1 -1
