20
1 20 1 0 163 258 6 -1 -1
2 20 1 255 128 162 9 -1 -1
3 20 1 417 97 162 8 -1 -1
4 20 1 576 64 161 7 -1 -1
5 20 1 800 161 32 7 -1 -1
6 20 1 863 129 33 8 -1 -1
7 20 1 928 97 32 8 -1 -1
8 20 1 1087 64 97 8 -1 -1
9 20 1 1217 63 95 6 -1 -1
10 20 1 1151 160 98 7 -1 -1
11 40 1 728 70 8 138 -1 -1
12 40 1 799 167 7 41 -1 -1
13 40 1 825 167 7 41 -1 -1
14 40 1 864 137 9 79 -1 -1
15 40 1 889 136 6 89 -1 -1
16 40 1 927 104 7 105 -1 -1
17 40 1 952 104 8 68 -1 -1
18 20 1 960 159 134 5 -1 -1
19 40 -1 1088 71 7 89 -1 -1
20 40 1 578 70 6 26 -1 -1
