13
1 20 1 0 162 259 5 -1 -1
2 20 1 254 131 166 7 -1 -1
3 20 1 417 100 161 5 -1 -1
4 20 1 575 67 161 7 -1 -1
5 20 1 800 164 32 5 -1 -1
6 20 1 863 131 33 8 -1 -1
7 20 1 929 99 33 7 -1 -1
8 40 1 727 77 8 122 -1 -1
9 40 -1 800 169 8 35 -1 -1
10 40 -1 866 139 6 62 -1 -1
11 40 -1 825 170 5 29 -1 -1
12 40 -1 889 140 7 58 -1 -1
13 40 -1 928 107 7 89 -1 -1
